%%%%%%
%....%
%G  G%
%.GG.%
%..P.%
%%%%%%
