%%%%%%
%  . %
%G   %
%G   %
%  P %
%%%%%%
