%%%%%%
%  . %
%G  G%
% GG %
%  P %
%%%%%%
